000000000
009406500
070030010
200000001
800000002
040000090
004000900
000709000
000040000
