846000000
020140705
010396048
090612070
381000420
670830500
438061952
109023680
007980034
