000400009
020980030
093000840
000000000
200008067
160300002
049000650
600003000
000059010
