000000000
890000005
000000040
000000000
000000000
000000000
010029000
040180203
002003090
